   #####  
 ###   ## 
##   #  ##
#     @  #
#.  $    #
####   ###
   #  ##  
   ####   
