       #####
     ###   #
    ## . # #
   ##  $$  #
  ##  $. ###
 ## $  ###  
## .$. #    
#  @ ###    
#  . #      
######      
