 #####   
 #   ####
 #.     #
### $ # #
#  #   @#
#     ###
#  ##  # 
##     # 
 #.$#  # 
 #  #### 
 ####    
