########
#   #  #
# # #$.#
#    $.#
# # #$.#
#   #  #
#####@ #
    ####
